Andrej Kramaric,27,TSG Hoffenheim,Sturm,157,183,26
Jirí Pavlenka,26,Werder Bremen,Tor,162,181,19
Koen Casteels,26,VfL Wolfsburg,Tor,149,171,22
Robert Lewandowski,29,Bayern München,Sturm,206,170,36
Ron-Robert Zieler,29,VfB Stuttgart,Tor,136,170,34
Yann Sommer,29,Bor. Mönchengladbach,Tor,198,164,34
Péter Gulácsi,28,RB Leipzig,Tor,206,160,46
Alexander Schwolow,26,SC Freiburg,Tor,187,157,30
Lukás Hrádecky,28,Bayer 04 Leverkusen,Tor,138,153,15
Serge Gnabry,23,Bayern München,Mittelfeld,145,149,4
Roman Bürki,27,Borussia Dortmund,Tor,188,140,48
Rune Jarstein,33,Hertha BSC,Tor,176,140,36
Oliver Baumann,28,TSG Hoffenheim,Tor,151,136,15
Thorgan Hazard,25,Bor. Mönchengladbach,Mittelfeld,145,135,10
Timo Werner,22,RB Leipzig,Sturm,156,132,24
Kevin Trapp,28,Eintracht Frankfurt,Tor,170,130,40
Marco Reus,29,Borussia Dortmund,Mittelfeld,188,129,59
Maximilian Eggestein,21,Werder Bremen,Mittelfeld,143,118,25
Benjamin Pavard,22,VfB Stuttgart,Abwehr,26,117,91
Kai Havertz,19,Bayer 04 Leverkusen,Mittelfeld,229,116,113
Daniel Caligiuri,30,FC Schalke 04,Mittelfeld,57,115,58
Mats Hummels,29,Bayern München,Abwehr,83,114,31
Julian Brandt,22,Bayer 04 Leverkusen,Mittelfeld,154,113,41
Joshua Kimmich,23,Bayern München,Abwehr,150,113,37
Salif Sané,27,FC Schalke 04,Abwehr,7,112,105
Thomas Müller,28,Bayern München,Mittelfeld,146,111,35
Kevin Volland,26,Bayer 04 Leverkusen,Sturm,160,108,52
Kingsley Coman,22,Bayern München,Mittelfeld,115,108,7
Michael Gregoritsch,24,FC Augsburg,Mittelfeld,54,107,53
Jonathan Tah,22,Bayer 04 Leverkusen,Abwehr,130,107,23
Matthias Ginter,24,Bor. Mönchengladbach,Abwehr,90,104,14
Benjamin Hübner,29,TSG Hoffenheim,Abwehr,31,101,70
Abdou Diallo,22,Borussia Dortmund,Abwehr,9,100,91
Arjen Robben,34,Bayern München,Mittelfeld,34,100,66
Florian Müller,20,1. FSV Mainz 05,Tor,102,100,2
Alfred Finnbogason,29,FC Augsburg,Sturm,60,99,39
Luka Jovic,20,Eintracht Frankfurt,Sturm,142,98,44
Jadon Sancho,18,Borussia Dortmund,Mittelfeld,198,97,101
Sven Ulreich,29,Bayern München,Tor,33,96,63
Jérôme Boateng,29,Bayern München,Abwehr,53,95,42
Philipp Max,24,FC Augsburg,Abwehr,69,95,26
Robin Zentner,23,1. FSV Mainz 05,Tor,56,94,38
Ralf Fährmann,29,FC Schalke 04,Tor,57,94,37
Guido Burgstaller,29,FC Schalke 04,Sturm,28,93,65
Nico Schulz,25,TSG Hoffenheim,Abwehr,142,92,50
Michael Rensing,34,Fortuna Düsseldorf,Tor,110,92,18
Lars Bender,29,Bayer 04 Leverkusen,Abwehr,83,92,9
Naldo,35,FC Schalke 04,Abwehr,14,91,77
Anastasios Donis,21,VfB Stuttgart,Sturm,34,91,57
Thomas Delaney,26,Borussia Dortmund,Mittelfeld,93,91,2
Christian Günter,25,SC Freiburg,Abwehr,90,91,1
Charles Aránguiz,29,Bayer 04 Leverkusen,Mittelfeld,107,90,17
Nico Elvedi,21,Bor. Mönchengladbach,Abwehr,77,89,12
Ermin Bicakcic,28,TSG Hoffenheim,Abwehr,86,89,3
Max Kruse,30,Werder Bremen,Sturm,170,88,82
Mark Uth,26,FC Schalke 04,Sturm,-1,87,88
Sandro Wagner,30,Bayern München,Sturm,4,87,83
Jean-Kévin Augustin,21,RB Leipzig,Sturm,26,87,61
Lars Stindl,29,Bor. Mönchengladbach,Mittelfeld,62,87,25
Ante Rebic,24,Eintracht Frankfurt,Sturm,103,87,16
Kerem Demirbay,25,TSG Hoffenheim,Mittelfeld,141,86,55
Michael Esser,30,Hannover 96,Tor,170,85,85
Denis Zakaria,21,Bor. Mönchengladbach,Mittelfeld,80,84,4
Amine Harit,21,FC Schalke 04,Mittelfeld,-2,83,85
James Rodríguez,27,Bayern München,Mittelfeld,101,83,18
Sébastien Haller,24,Eintracht Frankfurt,Sturm,167,82,85
Joelinton,21,TSG Hoffenheim,Sturm,124,79,45
Dennis Geiger,20,TSG Hoffenheim,Mittelfeld,4,78,74
Kevin Kampl,27,RB Leipzig,Mittelfeld,114,78,36
Lucas Alario,25,Bayer 04 Leverkusen,Sturm,66,77,11
Yussuf Poulsen,24,RB Leipzig,Sturm,142,76,66
Ihlas Bebou,24,Hannover 96,Sturm,63,76,13
Kevin Vogt,26,TSG Hoffenheim,Abwehr,86,76,10
Christian Mathenia,26,1. FC Nürnberg,Tor,112,73,39
Leon Bailey,20,Bayer 04 Leverkusen,Sturm,59,73,14
Christian Pulisic,19,Borussia Dortmund,Mittelfeld,65,73,8
Dominique Heintz,24,SC Freiburg,Abwehr,76,73,3
Niklas Süle,22,Bayern München,Abwehr,106,72,34
Javi Martínez,29,Bayern München,Mittelfeld,69,72,3
Niclas Füllkrug,25,Hannover 96,Sturm,21,70,49
Lukas Klostermann,22,RB Leipzig,Abwehr,115,69,46
Marcel Sabitzer,24,RB Leipzig,Mittelfeld,103,69,34
Nadiem Amiri,21,TSG Hoffenheim,Mittelfeld,45,69,24
Marius Wolf,23,Borussia Dortmund,Mittelfeld,-2,68,70
David Alaba,26,Bayern München,Abwehr,134,67,67
Franck Ribéry,35,Bayern München,Mittelfeld,83,67,16
Valentino Lazaro,22,Hertha BSC,Mittelfeld,71,67,4
Niklas Moisander,32,Werder Bremen,Abwehr,70,67,3
Mario Götze,26,Borussia Dortmund,Sturm,114,66,48
Wendell,25,Bayer 04 Leverkusen,Abwehr,21,66,45
Pavel Kaderábek,26,TSG Hoffenheim,Mittelfeld,102,66,36
Vincenzo Grifo,25,SC Freiburg,Mittelfeld,95,66,29
Jonathan de Guzmán,30,Eintracht Frankfurt,Mittelfeld,54,66,12
Jean-Philippe Gbamin,22,1. FSV Mainz 05,Mittelfeld,78,66,12
Florian Grillitsch,22,TSG Hoffenheim,Mittelfeld,102,65,37
Nils Petersen,29,SC Freiburg,Sturm,87,65,22
Jeffrey Gouweleeuw,27,FC Augsburg,Abwehr,57,65,8
Raffael,33,Bor. Mönchengladbach,Sturm,29,64,35
Jonas Hofmann,26,Bor. Mönchengladbach,Mittelfeld,93,63,30
Ishak Belfodil,26,TSG Hoffenheim,Sturm,157,62,95
Thiago Alcántara,27,Bayern München,Mittelfeld,134,62,72
Alexander Nübel,21,FC Schalke 04,Tor,82,62,20
Ludwig Augustinsson,24,Werder Bremen,Abwehr,66,62,4
Danny da Costa,25,Eintracht Frankfurt,Abwehr,77,60,17
Lukasz Piszczek,33,Borussia Dortmund,Abwehr,73,60,13
Philipp Tschauner,32,Hannover 96,Tor,0,59,59
Alfredo Morales,28,Fortuna Düsseldorf,Mittelfeld,20,59,39
Christian Gentner,32,VfB Stuttgart,Mittelfeld,2,58,56
Robin Koch,22,SC Freiburg,Abwehr,26,58,32
Christoph Kramer,27,Bor. Mönchengladbach,Mittelfeld,48,58,10
Manuel Gulde,27,SC Freiburg,Abwehr,67,58,9
Kevin Akpoguma,23,Hannover 96,Abwehr,-3,57,60
Josip Brekalo,20,VfL Wolfsburg,Mittelfeld,37,57,20
Marwin Hitz,30,Borussia Dortmund,Tor,0,56,56
Yevhen Konoplyanka,28,FC Schalke 04,Mittelfeld,9,56,47
Nicolas Höfler,28,SC Freiburg,Mittelfeld,14,56,42
Karim Rekik,23,Hertha BSC,Abwehr,34,56,22
Bruma,23,RB Leipzig,Sturm,14,55,41
Kaan Ayhan,23,Fortuna Düsseldorf,Abwehr,89,55,34
Emil Forsberg,26,RB Leipzig,Mittelfeld,82,55,27
Dominik Kohr,24,Bayer 04 Leverkusen,Mittelfeld,34,55,21
Dayot Upamecano,19,RB Leipzig,Abwehr,43,55,12
Weston McKennie,19,FC Schalke 04,Mittelfeld,45,55,10
Benjamin Stambouli,27,FC Schalke 04,Mittelfeld,6,54,48
Samuel Sahin-Radlinger,25,Hannover 96,Tor,8,54,46
Salomon Kalou,32,Hertha BSC,Mittelfeld,70,54,16
Rani Khedira,24,FC Augsburg,Mittelfeld,81,53,28
Diego Demme,26,RB Leipzig,Mittelfeld,81,53,28
Suat Serdar,21,FC Schalke 04,Mittelfeld,2,52,50
Maximilian Arnold,24,VfL Wolfsburg,Mittelfeld,99,52,47
Karim Bellarabi,28,Bayer 04 Leverkusen,Sturm,83,52,31
Jordan Torunarigha,20,Hertha BSC,Abwehr,28,52,24
Gian-Luca Waldschmidt,22,SC Freiburg,Sturm,89,51,38
Martin Hinteregger,25,FC Augsburg,Abwehr,69,51,18
Marvin Plattenhardt,26,Hertha BSC,Abwehr,21,50,29
Josuha Guilavogui,27,VfL Wolfsburg,Mittelfeld,70,50,20
Stefan Bell,26,1. FSV Mainz 05,Abwehr,18,49,31
Daniel Baier,34,FC Augsburg,Mittelfeld,45,49,4
Nabil Bentaleb,23,FC Schalke 04,Mittelfeld,13,48,35
Kevin Wimmer,25,Hannover 96,Abwehr,-17,47,64
Admir Mehmedi,27,VfL Wolfsburg,Mittelfeld,97,47,50
Corentin Tolisso,23,Bayern München,Mittelfeld,11,47,36
Janik Haberer,24,SC Freiburg,Mittelfeld,74,47,27
Markus Suttner,31,Fortuna Düsseldorf,Abwehr,22,47,25
Per Skjelbred,31,Hertha BSC,Mittelfeld,27,47,20
Marcel Halstenberg,26,RB Leipzig,Abwehr,111,46,65
Lukas Rupp,27,TSG Hoffenheim,Mittelfeld,1,46,45
Nuri Sahin,29,Werder Bremen,Mittelfeld,24,46,22
Matija Nastasic,25,FC Schalke 04,Abwehr,25,46,21
Rafinha,32,Bayern München,Abwehr,33,46,13
Danny Latza,28,1. FSV Mainz 05,Mittelfeld,41,46,5
Leon Goretzka,23,Bayern München,Mittelfeld,112,45,67
Ibrahima Konaté,19,RB Leipzig,Abwehr,109,45,64
Santiago Ascacibar,21,VfB Stuttgart,Mittelfeld,-18,45,63
Makoto Hasebe,34,Eintracht Frankfurt,Abwehr,108,45,63
Felix Uduokhai,20,VfL Wolfsburg,Abwehr,9,45,36
Ádám Szalai,30,TSG Hoffenheim,Sturm,72,45,27
Oscar Wendt,32,Bor. Mönchengladbach,Abwehr,48,45,3
Stefan Ilsanker,29,RB Leipzig,Mittelfeld,9,44,35
John Brooks,25,VfL Wolfsburg,Abwehr,76,44,32
Julian Baumgartlinger,30,Bayer 04 Leverkusen,Mittelfeld,66,44,22
Alexander Hack,24,1. FSV Mainz 05,Abwehr,27,44,17
Davie Selke,23,Hertha BSC,Sturm,52,44,8
Konrad Laimer,21,RB Leipzig,Abwehr,49,44,5
Pirmin Schwegler,31,Hannover 96,Mittelfeld,-25,43,68
Kevin Danso,19,FC Augsburg,Abwehr,-7,43,50
Timo Baumgartl,22,VfB Stuttgart,Abwehr,3,43,40
Mark Flekken,25,SC Freiburg,Tor,8,43,35
Frederik Rönnow,25,Eintracht Frankfurt,Tor,9,43,34
Kenan Karaman,24,Fortuna Düsseldorf,Sturm,39,43,4
Jonathan Schmid,28,FC Augsburg,Mittelfeld,47,43,4
Fabian Lustenberger,30,Hertha BSC,Abwehr,46,43,3
Theodor Gebre Selassie,31,Werder Bremen,Abwehr,84,42,42
Fabian Bredlow,23,1. FC Nürnberg,Tor,13,42,29
Timothy Chandler,28,Eintracht Frankfurt,Abwehr,1,41,40
Waldemar Anton,22,Hannover 96,Abwehr,15,41,26
Mike Frantz,31,SC Freiburg,Mittelfeld,62,41,21
Milos Veljkovic,22,Werder Bremen,Abwehr,23,41,18
Marco Richter,20,FC Augsburg,Sturm,32,41,9
Filip Kostic,25,Eintracht Frankfurt,Mittelfeld,131,40,91
Dan-Axel Zagadou,19,Borussia Dortmund,Abwehr,56,40,16
Jetro Willems,24,Eintracht Frankfurt,Abwehr,1,39,38
Robin Quaison,24,1. FSV Mainz 05,Sturm,51,39,12
Karim Onisiwo,26,1. FSV Mainz 05,Sturm,80,38,42
Breel Embolo,21,FC Schalke 04,Sturm,-2,38,40
Maximilian Philipp,24,Borussia Dortmund,Mittelfeld,2,38,36
Claudio Pizarro,39,Werder Bremen,Sturm,52,38,14
Pavao Pervan,30,VfL Wolfsburg,Tor,39,38,1
Ondrej Duda,23,Hertha BSC,Mittelfeld,102,37,65
Sven Bender,29,Bayer 04 Leverkusen,Abwehr,70,37,33
David Abraham,32,Eintracht Frankfurt,Abwehr,15,37,22
Andreas Luthe,31,FC Augsburg,Tor,43,37,6
Willi Orban,25,RB Leipzig,Abwehr,119,36,83
Manuel Neuer,32,Bayern München,Tor,92,36,56
Raphael Guerreiro,24,Borussia Dortmund,Mittelfeld,72,35,37
Marvin Bakalorz,28,Hannover 96,Mittelfeld,8,35,27
Manuel Akanji,23,Borussia Dortmund,Abwehr,69,34,35
Stefan Posch,21,TSG Hoffenheim,Abwehr,37,34,3
Robin Knoche,26,VfL Wolfsburg,Abwehr,87,33,54
Erik Thommy,23,VfB Stuttgart,Mittelfeld,-15,33,48
Niklas Stark,23,Hertha BSC,Abwehr,61,33,28
Dennis Aogo,31,VfB Stuttgart,Mittelfeld,6,33,27
Florian Niederlechner,27,SC Freiburg,Sturm,11,33,22
Ömer Toprak,29,Borussia Dortmund,Abwehr,18,33,15
Vedad Ibisevic,33,Hertha BSC,Sturm,77,32,45
William,23,VfL Wolfsburg,Abwehr,47,32,15
Mitchell Weiser,24,Bayer 04 Leverkusen,Abwehr,25,32,7
Tobias Strobl,28,Bor. Mönchengladbach,Mittelfeld,61,31,30
Pascal Stenzel,22,SC Freiburg,Abwehr,16,31,15
Daniel Brosinski,30,1. FSV Mainz 05,Abwehr,40,31,9
Mario Gomez,33,VfB Stuttgart,Sturm,-18,30,48
Gregor Kobel,20,FC Augsburg,Tor,58,30,28
Amadou Haidara,20,RB Leipzig,Mittelfeld,15,30,15
Linton Maina,19,Hannover 96,Mittelfeld,8,29,21
Florian Kainz,25,Werder Bremen,Mittelfeld,18,29,11
Gelson Fernandes,31,Eintracht Frankfurt,Mittelfeld,35,29,6
Simon Falette,26,Eintracht Frankfurt,Abwehr,-12,28,40
Holger Badstuber,29,VfB Stuttgart,Abwehr,-9,28,37
Shinji Kagawa,29,Borussia Dortmund,Mittelfeld,1,28,27
Ja-Cheol Koo,29,FC Augsburg,Mittelfeld,6,28,22
Leonardo Bittencourt,24,TSG Hoffenheim,Mittelfeld,35,28,7
Milot Rashica,22,Werder Bremen,Sturm,107,27,80
Julian Korb,26,Hannover 96,Abwehr,-17,27,44
Daniel Ginczek,27,VfL Wolfsburg,Sturm,62,27,35
Omar Mascarell,25,FC Schalke 04,Mittelfeld,-3,27,30
Steven Zuber,26,TSG Hoffenheim,Mittelfeld,45,27,18
Caiuby,30,FC Augsburg,Mittelfeld,12,27,15
Julian Weigl,22,Borussia Dortmund,Mittelfeld,40,27,13
Ignacio Camacho,28,VfL Wolfsburg,Mittelfeld,24,27,3
Nordi Mukiele,20,RB Leipzig,Abwehr,59,26,33
Marcelo Saracchi,20,RB Leipzig,Abwehr,21,26,5
Yunus Malli,26,VfL Wolfsburg,Mittelfeld,22,26,4
Martin Harnik,31,Werder Bremen,Sturm,30,26,4
Ibrahima Traoré,30,Bor. Mönchengladbach,Sturm,28,26,2
Philipp Bargfrede,29,Werder Bremen,Mittelfeld,26,26,0
Berkay Özcan,20,VfB Stuttgart,Mittelfeld,-3,25,28
Fabian Giefer,28,FC Augsburg,Tor,-2,25,27
Benjamin Henrichs,21,Bayer 04 Leverkusen,Abwehr,2,25,23
Anthony Ujah,27,1. FSV Mainz 05,Sturm,36,25,11
Sebastian Rudy,28,FC Schalke 04,Mittelfeld,-28,24,52
Emile Smith Rowe,18,RB Leipzig,Mittelfeld,3,24,21
Marvin Ducksch,24,Fortuna Düsseldorf,Sturm,4,24,20
Tyler Adams,19,RB Leipzig,Mittelfeld,42,24,18
Bastian Oczipka,29,FC Schalke 04,Abwehr,20,24,4
Mijat Gacinovic,23,Eintracht Frankfurt,Mittelfeld,27,24,3
Matheus Cunha,19,RB Leipzig,Sturm,27,24,3
Yannick Gerhardt,24,VfL Wolfsburg,Mittelfeld,70,23,47
Isaac Thelin,26,Bayer 04 Leverkusen,Sturm,3,23,20
Tim Kleindienst,22,SC Freiburg,Sturm,2,22,20
Chadrac Akolo,23,VfB Stuttgart,Sturm,-4,21,25
Vladimír Darida,27,Hertha BSC,Mittelfeld,4,21,17
Maximilian Mittelstädt,21,Hertha BSC,Abwehr,9,21,12
Ridle Baku,20,1. FSV Mainz 05,Mittelfeld,29,21,8
Andreas Beck,31,VfB Stuttgart,Abwehr,29,21,8
Adam Bodzek,32,Fortuna Düsseldorf,Mittelfeld,13,21,8
Aleksandar Dragovic,27,Bayer 04 Leverkusen,Abwehr,47,20,27
Franco Di Santo,29,FC Schalke 04,Sturm,-3,20,23
Pablo De Blasis,30,1. FSV Mainz 05,Mittelfeld,0,20,20
Gerrit Holtmann,23,1. FSV Mainz 05,Abwehr,5,20,15
Marco Terrazzino,27,SC Freiburg,Mittelfeld,8,20,12
Mathew Leckie,27,Hertha BSC,Mittelfeld,27,20,7
Matthias Zimmermann,26,Fortuna Düsseldorf,Abwehr,52,19,33
Yuya Osako,28,Werder Bremen,Sturm,48,19,29
Håvard Nordtveit,28,TSG Hoffenheim,Abwehr,8,19,11
Lukas Kübler,25,SC Freiburg,Abwehr,27,19,8
Mahmoud Dahoud,22,Borussia Dortmund,Mittelfeld,15,19,4
Amir Abrashi,28,SC Freiburg,Mittelfeld,15,19,4
Daniel Didavi,28,VfB Stuttgart,Mittelfeld,20,19,1
Jérôme Gondorf,30,SC Freiburg,Mittelfeld,36,18,18
Patrick Herrmann,27,Bor. Mönchengladbach,Sturm,35,18,17
Felix Klaus,25,VfL Wolfsburg,Mittelfeld,20,18,2
André Hahn,27,FC Augsburg,Mittelfeld,41,17,24
Jan Morávek,28,FC Augsburg,Mittelfeld,-2,17,19
Gonzalo Castro,31,VfB Stuttgart,Mittelfeld,8,17,9
Jaroslav Drobny,38,Fortuna Düsseldorf,Tor,8,17,9
Josip Drmic,25,Bor. Mönchengladbach,Sturm,9,17,8
Niko Bungert,31,1. FSV Mainz 05,Abwehr,14,17,3
Aron Jóhannsson,27,Werder Bremen,Sturm,1,16,15
Tony Jantschke,28,Bor. Mönchengladbach,Abwehr,27,16,11
Emiliano Insúa,29,VfB Stuttgart,Abwehr,-27,15,42
Sebastian Langkamp,30,Werder Bremen,Abwehr,30,15,15
Alexandru Maxim,28,1. FSV Mainz 05,Mittelfeld,29,15,14
Fin Bartels,31,Werder Bremen,Sturm,2,15,13
Carlos Salcedo,24,Eintracht Frankfurt,Abwehr,6,15,9
Dong-Won Ji,27,FC Augsburg,Sturm,17,15,2
Walace,23,Hannover 96,Mittelfeld,16,15,1
Iver Fossum,22,Hannover 96,Mittelfeld,-4,14,18
Nicolai Müller,30,Eintracht Frankfurt,Mittelfeld,-1,14,15
Marco Russ,32,Eintracht Frankfurt,Abwehr,2,14,12
Paul Verhaegh,34,VfL Wolfsburg,Abwehr,2,14,12
Jonathas,29,Hannover 96,Sturm,-1,13,14
Jakub Blaszczykowski,32,VfL Wolfsburg,Mittelfeld,1,13,12
Marc-Oliver Kempf,23,VfB Stuttgart,Abwehr,24,13,11
Stefanos Kapino,24,Werder Bremen,Tor,3,13,10
Marcel Tisserand,25,VfL Wolfsburg,Abwehr,15,13,2
Rouwen Hennings,30,Fortuna Düsseldorf,Sturm,60,12,48
Oliver Fink,36,Fortuna Düsseldorf,Mittelfeld,56,12,44
Peter Pekarík,31,Hertha BSC,Abwehr,-3,12,15
Uffe Bech,25,Hannover 96,Mittelfeld,2,12,10
Giulio Donati,28,1. FSV Mainz 05,Abwehr,17,12,5
Takashi Usami,26,Fortuna Düsseldorf,Mittelfeld,16,12,4
Edgar Prib,28,Hannover 96,Mittelfeld,9,12,3
Marcin Kaminski,26,Fortuna Düsseldorf,Abwehr,35,11,24
Marco Fabián,29,Eintracht Frankfurt,Mittelfeld,-2,11,13
Yoric Ravet,28,SC Freiburg,Mittelfeld,-2,11,13
Marco Friedl,20,Werder Bremen,Abwehr,2,11,9
Michaël Cuisance,18,Bor. Mönchengladbach,Mittelfeld,3,11,8
Thomas Kraft,30,Hertha BSC,Tor,7,11,4
Felipe,31,Hannover 96,Abwehr,14,11,3
Paco Alcácer,24,Borussia Dortmund,Sturm,116,10,106
Andre Hoffmann,25,Fortuna Düsseldorf,Abwehr,32,10,22
Fabian Johnson,30,Bor. Mönchengladbach,Mittelfeld,18,10,8
Gian-Luca Itter,19,VfL Wolfsburg,Abwehr,3,10,7
Alessandro Schöpf,24,FC Schalke 04,Mittelfeld,3,10,7
Luca Plogmann,18,Werder Bremen,Tor,3,10,7
Matthias Ostrzolek,28,Hannover 96,Abwehr,-18,9,27
Ondrej Petrák,26,1. FC Nürnberg,Mittelfeld,4,9,5
Wout Weghorst,25,VfL Wolfsburg,Sturm,161,8,153
Axel Witsel,29,Borussia Dortmund,Mittelfeld,126,8,118
Davy Klaassen,25,Werder Bremen,Mittelfeld,103,8,95
Kevin Möhwald,25,Werder Bremen,Mittelfeld,49,8,41
Raphael Framberger,22,FC Augsburg,Abwehr,-3,8,11
Jérôme Roussillon,25,VfL Wolfsburg,Abwehr,139,7,132
Sebastian Rode,27,Eintracht Frankfurt,Mittelfeld,44,7,37
Arne Maier,19,Hertha BSC,Mittelfeld,41,7,34
Tin Jedvaj,22,Bayer 04 Leverkusen,Abwehr,-5,7,12
Haji Wright,20,FC Schalke 04,Sturm,2,7,5
Florian Neuhaus,21,Bor. Mönchengladbach,Mittelfeld,89,6,83
Elvis Rexhbecaj,20,VfL Wolfsburg,Mittelfeld,49,6,43
Johannes Eggestein,20,Werder Bremen,Sturm,41,6,35
Nicolás González,20,VfB Stuttgart,Sturm,-17,6,23
Miiko Albornoz,27,Hannover 96,Abwehr,-11,6,17
Alexander Esswein,28,VfB Stuttgart,Mittelfeld,-10,6,16
Marc Stendera,22,Eintracht Frankfurt,Mittelfeld,13,6,7
Christoph Daferner,20,SC Freiburg,Sturm,1,6,5
Alassane Pléa,25,Bor. Mönchengladbach,Sturm,104,5,99
Michael Lang,27,Bor. Mönchengladbach,Abwehr,35,5,30
Gonçalo Paciência,24,Eintracht Frankfurt,Sturm,33,5,28
Adam Zrelák,24,1. FC Nürnberg,Sturm,-19,5,24
Hamza Mendyl,20,FC Schalke 04,Abwehr,-16,5,21
Steven Skrzybski,25,FC Schalke 04,Mittelfeld,19,5,14
Renato Sanches,20,Bayern München,Mittelfeld,15,5,10
Federico Palacios,23,1. FC Nürnberg,Sturm,-4,5,9
Jonas Carls,21,FC Schalke 04,Abwehr,-4,5,9
Edgar Salli,25,1. FC Nürnberg,Sturm,-4,5,9
Simon Rhein,20,1. FC Nürnberg,Mittelfeld,-3,5,8
George Timotheou,21,FC Schalke 04,Abwehr,0,5,5
Sascha Riether,35,FC Schalke 04,Abwehr,1,5,4
Julian Schieber,29,FC Augsburg,Sturm,1,5,4
Jean-Philippe Mateta,21,1. FSV Mainz 05,Sturm,108,4,104
Jean-Paul Boëtius,24,1. FSV Mainz 05,Mittelfeld,85,4,81
Dodi Lukebakio,20,Fortuna Düsseldorf,Sturm,75,4,71
Pierre Kunde,23,1. FSV Mainz 05,Mittelfeld,56,4,52
Hanno Behrens,28,1. FC Nürnberg,Mittelfeld,37,4,33
Joshua Brenet,24,TSG Hoffenheim,Mittelfeld,33,4,29
Eduard Löwen,21,1. FC Nürnberg,Mittelfeld,28,4,24
Dawid Kownacki,21,Fortuna Düsseldorf,Sturm,27,4,23
Genki Haraguchi,27,Hannover 96,Mittelfeld,-18,4,22
Borna Sosa,20,VfB Stuttgart,Abwehr,-18,4,22
Philipp Lienhart,22,SC Freiburg,Abwehr,23,4,19
Roland Sallai,21,SC Freiburg,Mittelfeld,23,4,19
Matheus Pereira,22,1. FC Nürnberg,Mittelfeld,21,4,17
Yuya Kubo,24,1. FC Nürnberg,Mittelfeld,-11,4,15
Oliver Sorg,28,Hannover 96,Abwehr,-10,4,14
Keven Schlotterbeck,21,SC Freiburg,Abwehr,17,4,13
Mikael Ishak,25,1. FC Nürnberg,Sturm,17,4,13
Marcel Schmelzer,30,Borussia Dortmund,Abwehr,16,4,12
Alexander Fuchs,21,1. FC Nürnberg,Mittelfeld,-7,4,11
Kasim Adams,23,TSG Hoffenheim,Abwehr,14,4,10
Alphonso Davies,17,Bayern München,Mittelfeld,14,4,10
Fredrik Jensen,20,FC Augsburg,Mittelfeld,-4,4,8
Lucas Torró,24,Eintracht Frankfurt,Mittelfeld,12,4,8
Allan Souza,21,Eintracht Frankfurt,Mittelfeld,-2,4,6
Taleb Tawatha,26,Eintracht Frankfurt,Abwehr,0,4,4
Philipp Mwene,24,1. FSV Mainz 05,Mittelfeld,8,4,4
Virgil Misidjan,25,1. FC Nürnberg,Mittelfeld,0,4,4
Patrick Kammerbauer,21,SC Freiburg,Mittelfeld,1,4,3
Woo-Yeong Jeong,18,Bayern München,Mittelfeld,1,4,3
Danny Blum,27,Eintracht Frankfurt,Sturm,1,4,3
Lukas Jäger,24,1. FC Nürnberg,Mittelfeld,2,4,2
Justin Hoogma,20,TSG Hoffenheim,Abwehr,3,4,1
Florent Muslija,20,Hannover 96,Mittelfeld,3,4,1
Patrick Erras,23,1. FC Nürnberg,Mittelfeld,3,4,1
Yvon Mvogo,24,RB Leipzig,Tor,5,4,1
Chima Okoroji,21,SC Freiburg,Abwehr,3,4,1
Sebastian Jung,28,VfL Wolfsburg,Abwehr,4,4,0
Kevin Stöger,24,Fortuna Düsseldorf,Mittelfeld,106,3,103
Benito Raman,23,Fortuna Düsseldorf,Sturm,91,3,88
Niko Gießelmann,26,Fortuna Düsseldorf,Abwehr,51,3,48
Achraf Hakimi,19,Borussia Dortmund,Abwehr,50,3,47
Ewerton,29,1. FC Nürnberg,Abwehr,43,3,40
Moussa Niakhaté,22,1. FSV Mainz 05,Abwehr,40,3,37
Georg Margreitter,29,1. FC Nürnberg,Abwehr,39,3,36
Jean Zimmer,24,Fortuna Düsseldorf,Abwehr,37,3,34
Hendrik Weydandt,23,Hannover 96,Sturm,32,3,29
Aarón Martín,31,Werder Bremen,Sturm,30,3,27
Marcel Sobottka,24,Fortuna Düsseldorf,Mittelfeld,25,3,22
Pablo Maffeo,21,VfB Stuttgart,Abwehr,-18,3,21
Paulinho,18,Bayer 04 Leverkusen,Sturm,19,3,16
Tim Leibold,24,1. FC Nürnberg,Abwehr,15,3,12
Abdul Rahman Baba,24,FC Schalke 04,Mittelfeld,-6,3,9
Felix Götze,20,FC Augsburg,Abwehr,9,3,6
Lukas Mühl,21,1. FC Nürnberg,Abwehr,9,3,6
Robin Bormuth,22,Fortuna Düsseldorf,Abwehr,8,3,5
Ramazan Özcan,34,Bayer 04 Leverkusen,Tor,8,3,5
Enrico Valentini,29,1. FC Nürnberg,Abwehr,6,3,3
Almamy Touré,22,Eintracht Frankfurt,Abwehr,3,3,0
Renato Steffen,26,VfL Wolfsburg,Mittelfeld,62,2,60
Javairô Dilrosun,20,Hertha BSC,Mittelfeld,36,2,34
Konstantinos Stafylidis,24,FC Augsburg,Abwehr,6,2,4
Tim Dierßen,22,Hannover 96,Mittelfeld,1,2,1
Gaëtan Bussmann,27,1. FSV Mainz 05,Abwehr,2,2,0
Marko Grujic,22,Hertha BSC,Mittelfeld,77,1,76
Lucas Höler,24,SC Freiburg,Sturm,31,1,30
Sebastian Kerk,24,1. FC Nürnberg,Mittelfeld,-21,1,22
Törles Knöll,20,1. FC Nürnberg,Sturm,12,1,11
Pascal Köpke,22,Hertha BSC,Sturm,8,1,7
David Otto,19,TSG Hoffenheim,Sturm,3,1,2
Ivo Ilicevic,31,1. FC Nürnberg,Mittelfeld,3,1,2
Georg Teigl,27,FC Augsburg,Mittelfeld,-1,1,2
Noah Joel Sarenren Bazee,21,Hannover 96,Mittelfeld,0,1,1
Branimir Hrgota,25,Eintracht Frankfurt,Sturm,1,1,0
Reiss Nelson,18,TSG Hoffenheim,Sturm,66,0,66
Robert Bauer,23,1. FC Nürnberg,Abwehr,-38,0,38
Ahmed Kutucu,18,FC Schalke 04,Sturm,16,0,16
Nassim Boujellab,19,FC Schalke 04,Mittelfeld,10,0,10
Derrick Luckassen,23,Hertha BSC,Abwehr,-6,0,6
Aymen Barkok,20,Fortuna Düsseldorf,Mittelfeld,6,0,6
Christoph Baumgartner,19,TSG Hoffenheim,Mittelfeld,-4,0,4
Rabbi Matondo,17,FC Schalke 04,Mittelfeld,2,0,2
Leon Dajaku,17,VfB Stuttgart,Sturm,2,0,2
Issah Abass,19,1. FSV Mainz 05,Sturm,1,0,1
László Bénes,20,Bor. Mönchengladbach,Mittelfeld,1,0,1
Takuma Asano,23,Hannover 96,Sturm,-30,-1,29
Jacob Bruun Larsen,19,Borussia Dortmund,Mittelfeld,11,-1,12
Lukas Klünter,22,Hertha BSC,Abwehr,4,-1,5
Timothy Tillman,19,1. FC Nürnberg,Mittelfeld,-5,-1,4
Sebastian Soto,18,Hannover 96,Sturm,3,-1,4
Benjamin Hadzic,19,Hannover 96,Sturm,3,-1,4
Kevin Goden,19,1. FC Nürnberg,Abwehr,-4,-1,3
Ahmet Gürleyen,19,1. FSV Mainz 05,Abwehr,1,-1,2
Alfons Amade,18,TSG Hoffenheim,Abwehr,1,-1,2
Louis Beyer,18,Bor. Mönchengladbach,Abwehr,1,-1,2
Hans Nunoo Sarpei,19,VfB Stuttgart,Mittelfeld,-2,-1,1
Jonathan Burkardt,18,1. FSV Mainz 05,Sturm,-2,-1,1
Leandro Barreiro,18,1. FSV Mainz 05,Mittelfeld,0,-1,1
Davor Lovren,19,Fortuna Düsseldorf,Mittelfeld,-2,-1,1
Evan Ndicka,18,Eintracht Frankfurt,Abwehr,65,-2,67
Ozan Kabak,18,VfB Stuttgart,Abwehr,41,-2,43
Sergio Córdova,20,FC Augsburg,Sturm,28,-2,30
Reece Oxford,19,FC Augsburg,Abwehr,-28,-2,26
Nico Schlotterbeck,18,SC Freiburg,Abwehr,12,-2,14
Jeffrey Bruma,26,FC Schalke 04,Abwehr,-10,-2,8
Dennis Jastrzembski,18,Hertha BSC,Mittelfeld,5,-2,7
Jozo Stanic,19,FC Augsburg,Abwehr,1,-2,3
Jan-Ingwer Callsen-Bracker,33,FC Augsburg,Abwehr,1,-2,3
Antonis Aidonis,17,VfB Stuttgart,Abwehr,1,-2,3
Christoph Janker,33,FC Augsburg,Abwehr,-3,-2,1
Joshua Sargent,18,Werder Bremen,Sturm,9,-3,12
John Yeboah,18,VfL Wolfsburg,Mittelfeld,4,-3,7
Florian Baak,19,Hertha BSC,Abwehr,1,-3,4
Josip Elez,24,Hannover 96,Abwehr,1,-3,4
Levin Öztunali,22,1. FSV Mainz 05,Mittelfeld,-4,-5,1
Palko Dárdai,19,Hertha BSC,Mittelfeld,2,-6,8
Bobby Wood,25,Hannover 96,Sturm,-10,-6,4
Cedric Teuchert,21,FC Schalke 04,Sturm,-5,-8,3
Simon Asta,17,FC Augsburg,Abwehr,-6,-8,2
Meritan Shabani,19,Bayern München,Mittelfeld,1,-12,13
